####################
#..................#
#....######........#
#....#....#........#
#....#....#........#
>.........B........#
#....#....#........#
#....######........#
#..................#
####################
