####################
#....~~~...........#
#....~~~....~~~....#
#..................#
#..""""............#
>..................>
#.........~~~......#
#..................#
#............""""..#
####################
