####################
#.............#....#
#..######.....#....#
#......*......#....#
#.............#....#
>..................>
#....######........#
#..................#
#..................#
####################
