####################
#.............."...#
#..................#
#.."....#..........#
#......##..........#
#.................>#
#..................#
#..................#
#..................#
####################
