####################
#..."..............#
#....~~~...........#
#....~~~...........#
#..................#
>.........*.......>#
#..................#
#....".............#
#..................#
####################
