####################
#......####........#
#..................#
#..#..........#....#
#..................#
#....######........#
#..................#
#....#.............#
#..................#
##########>#########
