####################
#..................#
#..#..#....#....#..#
#..................#
#....######........#
>.........B.......##
#....#....#....#...#
#..................#
#.............."...#
####################
