####################
#..~~~.....".......#
#..................#
#....###...........#
#..................#
>.........*.......>#
#....~~~...........#
#.............."...#
#..................#
####################
