####################
#..."......~.......#
#........~~~.......#
#..................#
#......+...........#
>.........*.......>#
#..................#
#.."...............#
#...........~~~....#
####################
