####################
#....#.............#
#....#...."........#
>..................#
#..##..............#
#.................>#
#......"...........#
#..................#
#.............#....#
####################
