####################
#....#####.........#
#..................#
#..................>
#...#........#.....#
#..................#
#...#........#.....#
#..................#
#......#####.......#
####################
