####################
#...####....####...#
#..................#
#...#........#.....#
#..................#
#...#........#.....#
#..................#
#...........##.....#
#..................#
##########>#########
