####################
#....~~~...........#
#..................#
#...".......~~~....#
#..................#
>......~~~........>#
#..................#
#.............."...#
#...~~~............#
####################
