####################
#..."..............#
#..................#
#....~~~.....~~~...#
#..................#
#..######..........#
#..................#
#..........######..#
#..................#
##########>#########
