####################
#....######........#
#..................#
#..#.....#.........#
#..#...............#
>.................>#
#........####......#
#..................#
#......#...........#
####################
