####################
#..."......".......#
#....~~~...........#
#....~~~...........#
#..............+...#
>.........*.......>#
#..................#
#..."..............#
#..................#
####################
